g g g g g g g g g g g g g g g g g g g g g g g g g g g g g g g g w w g g g g g g g g g g g g g g g g g g g g g g g g g g g g
g g g g g g g g g g g g g g g g g g g g g g g g g g g g g g g g w w g g g g g g g g g g g g g g g g g g g g g g g g g g g g
g g g g g g g g g g g g g g g g g g g g g g g g g g g g g g g g w w g g g g g g g g g g g g g g g g g g g g g g g g g g g g
g g g g g g g g g g g g g g g g g g g g g g g g g g g g g g g g w w g g g g g g g g g g g g g g g g g g g g g g g g g g g g
g g g g g g g g g g g g g g g g g g g g g g g g g g g g g g g g w w g g g g g g g g g g g g g g g g g g g g g g g g g g g g
g g g g g g g g g g g g g g g g g g g g g g g g g g g g g g g g w w g g g g g g g g b b b b b b b b b b b b b b b b g g g g
g g g g g g g g g g g g g g g g g g g g g g g g g g g g g g g g w w w g g g g g g g b g g g g g g g g g g g g g g b g g g g
g g g g g g g g g g g g g g g g g g g g g g g g g g g g g g g g g w w w g g g g g g b g g g g g g g g g g g g g g b g g g g
g g g g g g g g g g g g g g g g g g g g g g g g g g g g g g g g g g w w w g g g g g b g g g g g g g g g g g g g g b g g g g
g g g g g g g g g g g g g g g g g g g g g g g g g g g g g g g g g g g w w w g g g g b g g g g g g g g g g g g g g b g g g g
g g g g g g g g g g g g g g g g g g g g g g g g g g g g g g g g g g g g w w g g g g b g g g g g g g g g g g g g g b g g g g
g g g g g g g g g g g g g g g g g g g g g g g g g g g g g g g g g g g g w w g g g g b g g g g g g g g g g g g g g b g g g g
g g g g g g g g g g g g g g g g g g g g g g g g g g g g g g g g g g g g w w g g g g b b b b b b b b b b b b b b b b g g g g
g g g g g g g g g g g g g g g g g g g g g g g g g g g g g g g g g g g g w w g g g g g g g g g g g g g g g g g g g g g g g g
g g g g g g g g g g g g g g g g g g g g g g g g g g g g g g g g g g g g w w g g g g g g g g g g g g g g g g g g g g g g g g
g g g g g g g g g g g g g g g g g g g g g g g g g g g g g g g g g g g g w w g g g g g g g g g g g g g g g g g g g g g g g g
g g g g g g g g g g g g g g g g g g g g g g g g g g g g g g g g g g g g w w g g g g g g g g g g g g g g g g g g g g g g g g
g g g g g g g g g g g g g g g g g g g g g g g g g g g g g g g g g g g g w w g g g g g g g g g g g g g g g g g g g g g g g g
g g g g g g g g g g g g g g g g g g g g g g g g g g g g g g g g g g g g w w g g g g g g g g g g g g g g g g g g g g g g g g
g g g g g g g g g g g g g g g g g g g g g g g g g g g g g g g g g g g g w w g g g g g g g g g g g g g g g g g g g g g g g g
g g g g g g g g g g g g g g g g g g g g g g g g g g g g g g g g g g g g w w g g g g g g g g g g g g g g g g g g g g g g g g
g g g g g g g g g g g g g g g g g g g g g g g g g g g g g g g g g g g g w w g g g g g g g g g g g g g g g g g g g g g g g g
g g g g g g g g g g g g g g g g g g g g g g g g g g g g g g g g g g g g w w g g g g g g g g g g g g g g g g g g g g g g g g
g g g g g g g g g g g g g g g g g g g g g g g g g g g g g g g g g g g g g g g g g g g g g g g g g g g g g g g g g g g g g g
g g g g g g g g g g g g g g g g g g g g g g g g g g g g g g g g g g g g g g g g g g g g g g g g g g g g g g g g g g g g g g
g g g g g g g g g g g g g g g g g g g g g g g g g g g g g g g g g g g g g g g g g g g g g g g g g g g g g g g g g g g g g g
g g g g g g g g g g g g g g g g g g g g g g g g g g g g g g g g g g g g g g g g g g g g g g g g g g g g g g g g g g g g g g
g g g g g g g g g g g g g g g g g g g g g g g g g g g g g g g g g g g g g g g g g g g g g g g g g g g g g g g g g g g g g g
g g g g g g g g g g g g g g g g g g g g g g g g g g g g g g g g g g g g w w g g g g g g g g g g g g g g g g g g g g g g g g
g g g g g g g g g g g g g g g g g g g g g g g g g g g g g g g g g g g g w w g g g g g g g g g g g g g g g g g g g g g g g g
g g g g g g g g g g g g g g g g g g g g g g g g g g g g g g g g g g g g w w g g g g g g g g g g g g g g g g g g g g g g g g