S S S S S S S S S S S S S S S S S S S S S S S S S S S S S S S S S w w S S S S S S S S S S S S S S S S S S S S S S S S S S S S S
S i i i i i i i i i i i g g g g g g g g g g g g g g g g g g s s s w w g g g g g g g g g g g g g g g g g g g g g g g g g g g g S
S i i i i i i i i i i i i i g g g g g g g g g g g g g g g g s s s w w g g g g g g g g g g g g g g g g g g g g g g g g g g g g S
S i i i i i i i i i i i i i i g g g g g g g g g g g g g g s s s s w w g g g g g g g g g g g g g g g g g g g g g g g g g g g g S
S i i i i i i i i i i i i i i i g g g g g g g g g g g g s s s s s w w g g g g g g g g g g g g g g g g g g g g g g g g g g g g S
S i i i i i i i i i i i i i i i i g g g g g g g g g g g s s s s s w w g g g g g g g g g g g g g g g g g g g g g g g g g g g g S
S i i i i i i i i i i i i i i i i g g g g g g g g g g g g s s s s w w g g g g g g g g b b b b b b b b b b b b b b b b g g g g S
S i i i i i i i i i i i i i i i i g g g g g g g g g g g g s s s s w w w g g g g g g g b g g g g g g g g g g g g g g b g g g g S
S g i i i i i i i i i i i i i i i g g g g g g g g g g g g g s s s s w w w g g g g g g b g g g g g g g g g g g g g g b g g g g S
S g g g i i i i i i i i i i i i i g g g g g g g g g g g g g s s s s s w w w g g g g g b g g g g g g g g g g g g g g b g g g g S
S g g g g i i i i i i i i i i i i g g g g g g g g g g g g s s s s s s s w w w g g g g b g g g g g g g g g g g g g g b g g g g S
S g g g g g g g g g g g g g g g g g g g g g g g g g g g g s s s s s s s s w w g g g g b g g g g g g g g g g g g g g b g g g g S
S g g g g g g g g g g g g g g g g g g g g g g g g g g g s s s s s s s s s w w g g g g b g g g g g g g g g g g g g g b g g g g S
S g g g g g g g g g g g g g g g g g g g g g g g g g g g s s s s s s s s s w w g g g g b b b b b b b b b b b b b b b b g g g g S
S g g g g g g g g g g g g g g g g g g g g g g g g g g g g s s s s s s s s w w g g g g g g g g g g g g g g g g g g g g g g g g S
S g g g g g g g g g g g g g g g g g g g g g g g g g g g g s s s s s s s s w w g g g g g g g g g g g g g g g g g g g g g g g g S
S g g g g g g g g g g g g g g g g g g g g g g g g g g g g g s s s s s s s w w g g g g g g g g g g g g g g g g g g g g g g g g S
S g g g g g g g g g g g g g g g g g g g g g g g g g g g g g s s s s s s s w w g g g g g g g g g g S S g g g g g g g g g g g g S
S g g g g g g g g g g g g g g g g g g g g g g g g g g g g g s s s s s s s w w g g g g g g g g g S S S S g g g g g g g g g g g S
S g g g g g g g g g g g g g g g g g g g g g g g g g g g g s s s s s s s s w w g g g g g g g g g S S S S S g g g g g g g g g g S
S g g g g g g g g g g g g g g g g g g g g g g g g g g g g s s s s s s s s w w g g g g g g g g g S S S S S g g g g g g g g g g S
S g g g g g g g g g g g g g g g g g g g g g g g g g g g s s s s s s s s s w w g g g g g g g g g g S S S g g g g g g g g g g g S
S g g g g g g g g g g g g g g g g g g g g g g g g g g s s s s s s s s s s w w g g g g g g g g g g g S S g g g g g g g g g g g S
S g g g g g g g g g g g g g g g g g g g g g g g g g g s s s s s s s s s s w w g g g g g g g g g g g g g g g g g g g g g g g g S
S g g g g g g g g g g g g g g g g g g g g g g g g g g s s s s s s s s s s s s s g g g g g g g g g g g g g g g g g g g g g g g S
S g g g g g g g g g g g g g g g g g g g g g g g g g g s s s s s s s s s s s s s g g g g g g g g g g g g g g g g g g g g g g g S
S g g g g g g g g g g g g g g g g g g g g g g g g g g s s s s s s s s s s s s g g g g g g g g g g g g g g g g g g g g g g g g S
S g g g g g g g g g g g g g g g g g g g g g g g g g g g s s s s s s s s s s s g g g g g g g g g g g g g g g g g g g g g g g g S
S g g g g g g g g F F g g g g g g g g g g g g g g g g g g s s s s s s s s s s g g g g g g g g g g g g g g g g g g g g g g g g S
S g g g g g g g g F F g g g g g g g g g g g g g g g g g g s s s s s s s s s s g g g g g g g g g g g g g g g g g g g g g g g g S
S g g g g g g g g g g g g g g g g g g g g g g g g g g g g g g s s s s s s w w g g g g g g g g g g g g g g g g g g g g g g g g S
S g g g g g g g g g g g g g g g g g g g g g g g g g g g g g g s s s s s s w w g g g g g g g g g g g g g g g g g g g g g g g g S
S S S S S S S S S S S S S S S S S S S S S S S S S S S S S S S S S S S S S w w S S S S S S S S S S S S S S S S S S S S S S S S S